111111111111111111
1000010001000C0001
1000C1000100010001
10111101110C011111
100000000000000001
111110011111111001
10001001E000100001
101010010011100001
10100001C000P00001
101111111111001111
100010010001001001
1000100000CC000001
111111111111111111
